10101111000000000000000000
01010001111000000000000000
00101001111000000000000000
00010101111000000000000000
00001010001111000000000000
00000101001111000000000000
00000010101111000000000000
00000001010001111000000000
00000000101001111000000000
00000000010101111000000000
00000000001010001111000000
00000000000101001111000000
00000000000010101111000000
00000000000001010001111000
00000000000000101001111000
00000000000000010101111000
00000000000000001010001111
00000000000000000101001111
00000000000000000010101111
11100000000000000001010001
11100000000000000000101001
11100000000000000000010101
00111100000000000000001010
00111100000000000000000101
10111100000000000000000010
01000111100000000000000001
